################################
#-----------------------------##
#-----------------------------##
#-----------------------------##
#-----------------------------##
#-----------------------------##
#-----------------------------##
#-----------------------------##
#-----------------------------##
#-----------------------------##
#-----------------------------##
#-----------------------------##
#-----------------------------##
#-----------------------------##
#-----------------------------##
################################